# os
alias p='pwd'
alias u='cd ..'
alias g='grep'
alias gir='grep -ir'
alias ll='ls -al'
alias o='open'
alias c='clear'
alias h='history'
alias hg='history | grep'
alias e='env'
alias E='env | grep ENV'

# git
alias gs='git status'
alias gl='git log'
alias ga='git add'
alias gp='git pull'
alias gf='git fetch'
alias gd='git diff'
alias gdc='git diff --cached'
alias gba='git branch -a'
alias gbd='git branch -d'
alias gps='git push'
alias gco='git checkout'
alias gcb='git checkout -b'
alias gcm='git commit -m'
alias gcl='git clone'
alias gst='git stash'
alias gsl='git stash list'
alias gsa='git stash apply'

# maven
alias mi='mvn install'
alias mis='mvn install -DskipTests'
alias mc='mvn clean'
alias mci='mvn clean install'
alias mcis='mvn clean install -DskipTests'
alias muci='mvn -U clean install'
alias mucis='mvn -U clean install -DskipTests'
alias msbr='mvn spring-boot:run'
alias pit='mvn clean test-compile org.pitest:pitest-maven:mutationCoverage -Daspectj.skip=true'
